# Rime table
# coding: utf-8
#
# è¯·å°†è¯¥æ–‡ä»¶ä»¥UTF-8ç¼–ç ä¿å­˜ä¸º
# Rimeç”¨æˆ·æ–‡ä»¶å¤¹/custom_phrase.txt
#
# ç è¡¨å„å­—æ®µä»¥åˆ¶è¡¨ç¬¦ï¼ˆTabï¼‰åˆ†éš”
# é¡ºåºä¸ºï¼šæ–‡å­—ã€ç¼–ç ã€æƒé‡ï¼ˆå†³å®šé‡ç çš„æ¬¡åºã€å¯é€‰ï¼‰
#
# è™½ç„¶æ–‡æœ¬ç è¡¨ç¼–è¾‘è¾ƒä¸ºæ–¹ä¾¿ï¼Œä½†ä¸é€‚åˆå¯¼å…¥å¤§é‡æ¡ç›®

ä¸­å·éŸµè¾“å…¥æ³•å¼•æ“	rime	2
https://rime.im/	rime	1
Rime	rime	3
âŒ˜	cmd
âŒ˜	command
âŒƒ	ctl
âŒƒ	control
âŒ¥	opt
âŒ¥	option
â‡§	shift

Android	android
Apple	apple
Apple ID	appleid
Clash	clash
Cloudflare	cloudflare
Cloudflare Workers	cloudflareworkers
CSS	css
Dropbox	dropbox
Docker	docker
GBK	gbk
GitHub	github
Google	google
Linux linux
HTML	html
iCloud	icloud
iMac	imac
iOS	ios
iPad	ipad
iPad	ipad
iPhone	iphone
iPhone XÊ€	iphonexr
iPod	ipod
IPTV	iptv
IPv4	ipv
IPv6	ipv
iTunes	itunes
Java	java
JavaScript	javascript
jQuery	jquery
Linux	linux
Mac	mac
Mac App Store	mas
MacBook	macbook
MacBook Air	mba
MacBook Pro	mbp
macOS	macos	8
macOS Sequoia	macos	7
macOS Sonoma	macos	6
macOS Ventura	macos	5
macOS Monterey	macos	4
macOS Catalina	macos	3
macOS Mojave	macos	2
macOS High Sierra	macos	1
Magisk	magisk
Minecraft	minecraft
MySQL	mysql
Objective-C	ojbc
OneDrive	onedrive
OS X	osx
Pixel	pixel
Python	python
QQ é‚®ç®±	qqyzxl
Quantumult	quantumult
Ruby	ruby
Rust	rust
SQL	sql
Stash	stash
Surge	surge
Swift	swift
Tailscale	tailscale
TypeScript	typescript
Tæ¤	txu
UTF-8	utfba
Uç›˜	upj
WeChat	wechat
Wi-Fi	wifi
Windows	win
Windows	windows
X-Ray	xray
Xbox	xbox
Xbox One	xboxone
YouTube	youtube
ZeroTier	zerotier
åˆåŒå’å•	yyy
åˆåŒå’å•	yzyzyz
ğŸ™‚	tmtt	å¾®ç¬‘
ğŸ™ƒ	tmtt	å¾®ç¬‘
ğŸ˜†	ddtt	å¤§ç¬‘
ğŸ˜‚	ttkk	ç¬‘å“­
ğŸ¤£	ttkk	ç¬‘å“­
ğŸ¥°	ep	çˆ±
ğŸ¤©	kffg	å“‡
ğŸ¥¶	dndn	å°´å°¬
ğŸ¤—	tada	tada
ğŸ‘	xk	å¼º
ğŸ‘	rhk	ç‰›
ğŸ˜­	ddkk	å¤§å“­
ğŸ¥³	ydpy	åº†ç¥
ğŸ˜	tdgk	æ™ºå›Š
ğŸ˜‰	ryhv	æŒ¤çœ¼
ğŸ˜‰	ryhv	çœ¨çœ¼
ğŸ˜Š	skep	å¯çˆ±
ğŸ˜	klkl	å˜¿å˜¿
ğŸ˜	kftd	åèˆŒ
ğŸ˜›	kftd	åèˆŒ
ğŸ˜‹	vbkt	å¥½åƒ
ğŸ˜š	usus	äº²äº²
ğŸ˜˜	epwq	çˆ±ä½ 
ğŸ˜—	usus	äº²äº²
ğŸ˜™	usus	äº²äº²
ğŸ¤©	wow	wow
ğŸ˜¤	tgrn	ç”Ÿæ°”
ğŸ˜³	ks	å‘†
ğŸ˜¡	tgrn	ç”Ÿæ°”
ğŸ¤¬	kkww	éª‚äºº
ğŸ¤«	khag	å˜˜
ğŸ¤”	lnft	æ€è€ƒ
ğŸ¤—	tada	tada
ğŸ¤—	wala	wala
ğŸ˜“	ifh	æ±—
ğŸ¤®	tgug	ç”Ÿç—…
ğŸ¤’	ntoa	å‘çƒ§
ğŸ¤§	thiu	é¼»æ¶•
ğŸ¤§	dgjh	æ„Ÿå†’
ğŸ‘½	qjww	å¤–æ˜Ÿäºº
ğŸ¤	ufkh	é—­å˜´
ğŸ¥±	kwqw	å“ˆæ¬ 
ğŸ¥±	lsbn	å›°äº†
ğŸ˜´	htip	ç¡è§‰
ğŸ˜ª	htip	ç¡è§‰
ğŸ˜ª	htud	ç¡ç€
ğŸ’€	meme	éª·é«…
ğŸ’©	ococ	ç²‘ç²‘
ğŸ’©	wgwg	ä¾¿ä¾¿
ğŸ‘»	rqc	é¬¼
ğŸ˜ˆ	ahgo	é‚ªæ¶
âœŒğŸ»	bbh	è€¶
âœŒğŸ»	yeah	è€¶
ğŸ¤¦ğŸ»â€â™‚ï¸	kdb	å‘ƒ
ğŸ™ğŸ»	pypy	ç¥ˆç¥·
â­	ggjt	äº”æ˜Ÿ